運算式述句	運算式本身就能成為述句，譬如「3」、「foo()」、「x or y」
指派述句	運算子包括=、+=、-=、*=、/=、//=、%=、**=、>>=、<<=、&=、^=、|=
assert述句	斷言述句，通常用於除錯
pass述句	什麼事情也不做的述句
del述句		刪除名稱以及與物件之間的綁定關係
return述句	離開函式並回傳某值或None
yield述句	只能用於產生器函式內
raise述句	引發異常
break述句	只能用於for與while迴圈之內，立即中止最靠近它的那一層迴圈
continue述句	立即跳到最靠近它的那一層迴圈的下一輪
import述句	匯入模組
gloibal述句	宣告名稱位於全域範圍內
nonlocal述句	宣告名稱位於函示範圍內
if述句		條件判斷式
while述句	while迴圈
for述句		for迴圈
try述句		異常處理
with述句	把一組程式述句包起來，由文脈管理器負責進入與離開的情況
def述句		函式定義
class述句	類別定義